   NO                 textures/joao.xpm


WE     ./textures/jesus.xpm

EA   ./textures/maria.xpm

 F    0 ,248 ,220
SO   ./textures/pedronolasco.xpm



C 125,206,200

        1111111111111111111111111
        1000000001000001100000001
        1011000001000000000000001
        1001000001000000000000001
111111111011000000000000000000001
100000000011000000000000000111111
1110000000000000000000000001
11110111111111111111111111111
111111     111111111111111111
10000011111110001100000000001
10000000000000000000000000001
11000001110101011111000000E01
11110001 1110101 101000000001
11111111 1111111 111111111111

